-----@-@---@---@
@@-@@@-@@@-@-@@@
---@-----@------
@@-@-@@@-@@@-@@@
-----@---@-----@
@@@@-@-@-@-@@@-@
-@---@-@---@---@
-@-@-@-@@@-@@@-@
---@-----@---@-@
@@@@-@-@@@-@@@--
