-------@-@---------@-----------@-@-@---
-@-@-@@@-@@@-@@@@@@@-@@@@@@@-@@@-@-@-@-
-@-@-----------------@-@---@---@-@-@-@-
@@@@@@-@@@@@@@-@-@@@@@-@-@@@@@-@-@-@-@-
---------@-@-----------@---@-------@-@-
-@@@-@-@@@-@-@@@@@-@@@-@-@@@@@-@@@-@-@-
-@---@-------@-@-@-@---@---@---@-----@-
-@@@-@@@@@@@@@-@-@@@-@-@-@@@@@@@-@@@-@-
-@-@---@-@-----@-----@-@---@---------@-
@@-@-@-@-@-@@@-@-@@@@@@@-@-@@@-@-@@@-@-
-----@-------@-----------@-@---@-@-@-@-
@@@@-@-@@@-@@@@@@@@@-@@@@@-@-@-@@@-@@@@
-----@---@---------------@---@---------